11111111111111111111
10000000000000000001
10000000000000000001
10000000000000000001
10111110000101010001
10100010000000000001
10100010000100010001
10100010000000000001
10110110000101010001
10000000000000000001
10000000000000000001
10000000000000000001
10000000000000000001
10000000000000000001
10000000000000000001
10000000000000000001
11111000000000000001
10000000000000000001
10001000000000000001
11111111111111111111
